28;31
30,10,10,10,10,10,10,10,10,10,10,10,10,31,30,10,10,10,10,10,10,10,10,10,10,10,10,31
13, 0, 0, 0, 0, 0, 0, 0, 0, 0, 0, 0, 0,12,13, 0, 0, 0, 0, 0, 0, 0, 0, 0, 0, 0, 0,12
13, 0,20,11,11,21, 0,20,11,11,11,21, 0,12,13, 0,20,11,11,11,21, 0,20,11,11,21, 0,12
13, 1,12,14,14,13, 0,12,14,14,14,13, 0,12,13, 0,12,14,14,14,13, 0,12,14,14,13, 1,12
13, 0,22,10,10,23, 0,22,10,10,10,23, 0,22,23, 0,22,10,10,10,23, 0,22,10,10,23, 0,12
13, 0, 0, 0, 0, 0, 0, 0, 0, 0, 0, 0, 0, 0, 0, 0, 0, 0, 0, 0, 0, 0, 0, 0, 0, 0, 0,12
13, 0,20,11,11,21, 0,20,21, 0,20,11,11,11,11,11,11,21, 0,20,21, 0,20,11,11,21, 0,12
13, 0,22,10,10,23, 0,12,13, 0,22,10,10,31,30,10,10,23, 0,12,13, 0,22,10,10,23, 0,12
13, 0, 0, 0, 0, 0, 0,12,13, 0, 0, 0, 0,12,13, 0, 0, 0, 0,12,13, 0, 0, 0, 0, 0, 0,12
32,11,11,11,11,21, 0,12,32,11,11,21, 2,12,13, 2,20,11,11,33,13, 0,20,11,11,11,11,33
14,14,14,14,14,13, 0,12,30,10,10,23, 2,22,23, 2,22,10,10,31,13, 0,12,14,14,14,14,14
14,14,14,14,14,13, 0,12,13, 2, 2, 2, 2, 4, 4, 2, 2, 2, 2,12,13, 0,12,14,14,14,14,14
14,14,14,14,14,13, 0,12,13, 2,20,11,11,40,40,11,11,21, 2,12,13, 0,12,14,14,14,14,14
10,10,10,10,10,23, 0,22,23, 2,12,41,41,41,41,41,41,13, 2,22,23, 0,22,10,10,10,10,10
 3, 2, 2, 2, 2, 2, 0, 2, 2, 2,12,41,41,41,41,41,41,13, 2, 2, 2, 0, 2, 2, 2, 2, 2, 3
11,11,11,11,11,21, 0,20,21, 2,12,41,41,41,41,41,41,13, 2,20,21, 0,20,11,11,11,11,11
14,14,14,14,14,13, 0,12,13, 2,22,10,10,10,10,10,10,23, 2,12,13, 0,12,14,14,14,14,14
14,14,14,14,14,13, 0,12,13, 2, 2, 2, 2, 2, 2, 2, 2, 2, 2,12,13, 0,12,14,14,14,14,14
14,14,14,14,14,13, 0,12,13, 2,20,11,11,11,11,11,11,21, 2,12,13, 0,12,14,14,14,14,14
30,10,10,10,10,23, 0,22,23, 2,22,10,10,31,30,10,10,23, 2,22,23, 0,22,10,10,10,10,31
13, 0, 0, 0, 0, 0, 0, 0, 0, 0, 0, 0, 0,12,13, 0, 0, 0, 0, 0, 0, 0, 0, 0, 0, 0, 0,12
13, 0,20,11,11,21, 0,20,11,11,11,21, 0,12,13, 0,20,11,11,11,21, 0,20,11,11,21, 0,12
13, 0,22,10,31,13, 0,22,10,10,10,23, 0,22,23, 0,22,10,10,10,23, 0,12,30,10,23, 0,12
13, 1, 0, 0,12,13, 0, 0, 0, 0, 0, 0, 0, 2, 2, 0, 0, 0, 0, 0, 0, 0,12,13, 0, 0, 1,12
32,11,21, 0,12,13, 0,20,21, 0,20,11,11,11,11,11,11,21, 0,20,21, 0,12,13, 0,20,11,33
30,10,23, 0,22,23, 0,12,13, 0,22,10,10,31,30,10,10,23, 0,12,13, 0,22,23, 0,22,10,31
13, 0, 0, 0, 0, 0, 0,12,13, 0, 0, 0, 0,12,13, 0, 0, 0, 0,12,13, 0, 0, 0, 0, 0, 0,12
13, 0,20,11,11,11,11,33,32,11,11,21, 0,12,13, 0,20,11,11,33,32,11,11,11,11,21, 0,12
13, 0,22,10,10,10,10,10,10,10,10,23, 0,22,23, 0,22,10,10,10,10,10,10,10,10,23, 0,12
13, 0, 0, 0, 0, 0, 0, 0, 0, 0, 0, 0, 0, 0, 0, 0, 0, 0, 0, 0, 0, 0, 0, 0, 0, 0, 0,12
32,11,11,11,11,11,11,11,11,11,11,11,11,11,11,11,11,11,11,11,11,11,11,11,11,11,11,33